Garden Rose	Angel Sweetie Pie	Yellow Menace
Fair Unfair	negatorri	Greek God
Misnaming Love	beyond my thoughts	Beauty Guard
JRyno	Shocking Resident	Soberslap
Sgt. Traveler	Snowmass	Lol Fool
Transparent Reminder	Butter Finger	Crazy KupKakes
Windy Miller	Bunny Rabbit	Silent Eyes
Twinkle Twinkle	X mysterious X	Mind Probe
Non Sane	Super Stupid	Leatherleader
Sandman Girl	CyberWarrior	WustacheMax
paintbrushesandbubblegum	Janaphyxiate	ZStar Princess
Pill Head	Flower	Guitar Guts
FedoraTheExplora	Love Loop	liivey0urlifee
Sugary pinaple cake	Geekish – God	Smug Sorry
White Storm	Sweet Weapon	Rainbow Sweety
Yoyo Guitarist	smallybells	Number 1 Creamy
Coolguy	Tolphas	Feature Swag
Awesome Beauty	camerashy443	Super Giggles
Foxy	X Eclipse	Shadow of Love
Angel Snowflakes	Foxer	Independent Melvin
Kiss me tenderly	peaseblo	Open heart
mr. mister	CyberGypsy	It Wasn’t Me
Daisy Louise	Soakage Star	Pink Award
Silly Pie	Lover Dropper	enderfemale
Drone Ground	Happy Saint	shimmer
Nightingale	Magnificent-jelly	Triple Adorable
Swag Swamped	Lawrence Legend	BuII Frog
Nice Touch	Lazy Looser	DontStealMyBacon
Armando Broncas	Pureed	Crunchy Crunch
Kingdom Warrior	Romeos-cousin	Camille Grammer
Rainbow Pearls	Dumb Subject	Cool bubble
Panic Point	Princess Fuzzie	how tobe indie
I Ran Over The Easter Bunny	Cheeky girl	Dredd
Napalm Bomb	Block Beauty	Petter Uncle
Gonewithwind	Dolly	WarriorInPain
Gobble Crying	OneHappyIgloo	Leather leader
Knight	Fiddlesticks	Patriot Next
Troubadour	Bad Ass	Take Away
Hypnosis	I Hope	Crashtest
Pogue	Stolen King	Engaged Guilty
Classical John	White Honey	lets run away to yesterday
Born2Pizza	Princess Army	Borned Bond
Axmen Woman	Hazzle – Dazzle	Major Nonsense
Beloved-Angle	Zakhep	Angel Lamb
Moon Maker	Cuddle Bear	Deal Looser
Sorties Sorry	Single – tone	georgeyves
Tattoo Puncher	Innocent- heart	Kitty Melody
takenbyWine	Cyka_Bylat	Plot Racer
Senpai_XD	Chan14551	Perfect Harmony
Anonymous – Friend	MrExtinct	I Wisher
Mike Adamle	twilightvanillagalaxies	Flattering Law
Lemon Honeypie	Lovely Dove	Live Pink
Flyswat	Naughty Nuclei	Latest Marble
Vinous Hideous	Hashtag Hustle	Leostereo
You are so Wonk	TallButShort	Bun Bun
Toxic	Cute Magic	t oxickisses
MinecraftMasterz	Jax4321	Tango Tree
Honey Pot	livingfree8	sweet
Event Include	Media Dating	ayee erbear
ShockingCart	Criss Cross	THE CATFACE
Yaniv Ganzi	Fair Chine	Absolutely Shine
Rainbow Colours	Pure Manure	Painter Blue
Kitty Bloom	hipster retspih	Painter Activist
RunsWithFlyingDolphins	tea at five	Sandbox
For the lolz	Wayne	Ego Ever
shortbusgangster	NetFreak	Peach
Wazdorf	Dear sweetie	Aaroon21
Breakup Master	Genuine Rum	Gods Own Girl
Doodle Done	Tripple Fourth	Juilius_Sneezer
Loin Bridge	Madam Maid	katty
Dylanf3	Tulip wind	Dredd10190
Gold unseen	Baking Brain	Cute
Angel Goldfish	Divine	DarlingDragon
Shadow	Rainbow Kitty	HockeyWain
Baby Dream	Oops Lady	Nicky Jane
Gozmit	Zoom Fire	Bubble Hearts
Honey Buttercup	Hey_you_quinn	Painter Prank
Star Shadow	angelic	Yeah Me
Northern Glory	Transplant Soul	Matrix Incident
It's A Political Statement	Puerile	Chuckles
Dry Witness	lovely	Swag Football
BIG SEAN	Snow Princess	Brendan170
Lovely Poison	youreyes dontknowmeyet	Love Tweet
Don of Day	The Undertaker	HateTheG
ElfishPresley	sugar	Muffinhead
EyeCandyI	Pokie	Honeycake
KristyHoney	Pacific Paint	Right Choice Baby
OP_rah	Magnificent – jelly	Honey bear Snowflakes
Doll Face	TrippleFourth	Memory Mask
Mr. Dakota	Painter Crater	AWESOME LYK THaT
awrinkle in time	butterfly	Snap Zip
Invalid Objects	little	Pink prank
Showroom	Hitchhiker	Pasty
Leton Lee	Black Sheep	Zero Charisma
Lil Miss Silly	Fair Furs	Fabulous
Awesome angel	Cooler then Coolest	Little Miss Piggy
Crazy Eights	Petal Pose	Cool guy
Foxface	Flavours N Kiss	Happy
Soaker Silver	Candy Cane	Sober Slap
Snow Creamy	Inversely Cut	Diamond girl
Snerus	silverboyp	Pure wood
Popoff	Protein Punch	Purse Stand
Snow’s	Cute light	Slamming
Dawnofdusk	Creamy Crest	Little Miss Cupcake
First N Last Love	omfgorlaith	Dino Turn
Blade Ben	Creamie Pie	Fair Loose
Rose Rain	Jake Justin	Ex Comfy
News Deal	Beautiful	Baby Kristy
Always Teste	Whack Attack	Éclair Fair
Metro Young	Turnip King	Clear Marble
Smartness Leaks	Angel Friend	Top Command
BrokenSmile	Baby Cakes	Awesome girls
Summer Slamming	I Best	MomToWedThorFriday
they're lying 2 u	Choco Fudge	Preston
Baby Pie	atomic7732	Instagram Hideous
Drock	imarcore	Tickle Star
Snow Hound	Jelly Bean Brownies	angelic smiles
WellEndowedPenguin	n0y0u	Black Burry
Crying Cheer	Avenger	InTwoPieces
NinjasInPyjamas	NoahWeasley	Honey Cake Munchkin
Muro45	Syfaro	Peace Dude
Buttercup	Angry Motion	Grey Mare
JuliusSeizure	Doctor	Sarah
Doll beautiful	LastSummer	Soapy Boo
Exciting-diva	Hamish	Awesome me
pokemon pie	Loafer Fun	Young 90’s
Obvious Dump	mycrownmykingdom	Strawberry Applepie
Spinning Leaf	Ponectus	Goodbye Gang
Yad	TheEpicBlock	Damager Damn
Outlaw	Mistalee	Incident Story
Positive Next	NoisyNoise	Tiger Kitty
Silent Singer	Forren person numbah 4	Fate
Creative Comma	CreamiePie	Swampmasher
Leap Grave	Miss Thing	Happy Jock
Promo Punch	Grenade Sucker	Cutie
Rose Catcher	Waning Crying	Girly Guy
Angel Sweet Lips	Tweety Sweetie	Hideki Ryuga
Bronze Gamer	Ghost	SingleTomorrow
AmazingHuh	DeepDarkSamurai	Silver
yourea lion	Gone with wind	Grammar_Jew
Rainbow Forest	Angel Of Memories	Kisses
Manic Psycho	1thousand is super fantastic	marie mirabelle
Little Gorilla	Grey Model	Charming
Pocket smile	firehawk729	Delicately – delicious
Travuersa	Rif Raf	Dry Fisher
Lord-voldemort	Bubble Pops	Bandilainc
Seconds Of kisses	Dirty Teeth	Eye Fair
Kitty Angel	Cybertron	Cabman Woman
runnerman1	angel	Exciting – diva
Awesome pie	Mental World	Honey Girl
Fastdraw	Thirteenth Command	roebuck
Hooper Crush	Chronic Beauty	TEH CATFACE
Deal Cereal	Redwild10	IThinkALot
Nightmare King	Fear Swag	Manmade Nick
Angelwonderland	Baby Base	Queenlovesbong
HeadOfTheMiddle	AdolfCritler	Cobra Pun
Honey Bell	Walking Statue	Awesome Whisper
Awesomus Maximus	ITellMyselfSecrets	Freaky Fred Creep
Lovely Dear	Flexible Look	Big Ben
Waving Slamming	Bear	Miss Kick
iLikeMe	1ddreamoutloud	jesse
catlover2011	chiquitita	Taste The Thunder
okieedokieee	Rosanna	Huggable Bab
Lovely Creamy	Honey	claudia colombian
Smash Fun	Delta Nights	Wish 4 Bubbles
Bubbly	Bed Race	Elegant Friendship
Cute Insider	Papa Smurf	aCollectionOfCells
Darling Dragon	Past Eraser	David A
Marshmallow Man	Rare Rush	Pure Purport
Catchy Nails	Stratify	thegirl withstarsforeyes
Honeycomb	Secret Giggle	PluralizesEverythings
Meat Duck	Rollins	Gamer Slayer
CoolerthenCoolest	CountryGal	Sir_Loin
Fluffy	Terror Coast	Bad Captain
Check Cheer	Cute Pixel	GawdOfROFLS
Teen Boo	Angel Princess	Jacob Beautiful Mind
Fresh lime	Pure Teri	DilemaDoll
3D Season	mylifesabeautifuldisaster	Princess Rule
BattletoSettle	1ddreamoutland	megan eve
Hypnosb	Oodles	Gunhawk
JesusHentaiChrist	TasteTheThunder	aranamor
Racer	Delicious	Cookie
Ranging Ride	Bold Style	SecretAgent
Bee-Sting	Past Haunts	Twilight Queenbee
just my little wonderwall	Sugary Heaven	Annaandtheking
Angel candy	Crash Override	Innocent-heart
Kitty Cute	Cherry Pie	Genius – generous
Epic angel	Crush Hunter	BurnedOutHell
OperaOfDreams	Cheer will	crimson pain
Naylor Mysterious	ha ve faith in me	Passion
National Insecurity	Pinball Wizard	I Has A Question
Pink Lover	Crazy Anyone	Cute Circle
itsjohalibro	Drama Creator	The Prophet
Enough is enough	GouGou	Half Pure
wontobey	Smoothly	Meman5000
Sometimes Okie	Handy Man 7	Entophobia
Your parenting stinks	CoolBlueJ	Honey Cake Dumpling
Smiling Face	Million Likes	Big Fart
Made In Charms	Masterpiece Eyes	Joan Ofark
Battledoom	0hhey beautiful	AirFusion
Charismatic-doll	Choclate Oxygen	Honey bear Sunflower
Rainbow Doll	F0R1	Iamyou
Happy Murcia	nataaliacorrea	Jelly Fish
Slayer	Trucker	WirelessBrain
darkNightBrightDays	FlavoursNKiss	Roblox
CoreFinder	Biker	Stephen Returns
Wish4Bubbles	Tulip Bed	Sarah K
BillherePlease	DaBomb	emma ploess
Assasin	Circus Brain	IceSugarApple
Sweet Whimsy	cupcakes rock	Darvince
Doll Diamond	JollyFish	POTATO LOVER
Single-tone	Awesome Honey	FuNkY mOnEy
Ice Sugar Apple	Honey Sweet Lips	Colorless
Butterfly on rose	Black Sword	Pluto
Mystical Dimples	Bad Chatty	Black Hawk
Cute Sky	Eifersu	Pink Doll
Middle Rule	Fair Marble	Hot Babe
Beautiful doII	sparkling lace	Born confused
Cull Warner	Tumblr Tune	Pink Style
BornedBond	Emerald Princess	Elegant Splendor
Last Summer	Lovely Passion	Blade Fart
Mastic Crying	Zoropie5	Star Belt
KingoftheGil	No Rules	Naughty Draught
Planted Brain	Penguin Doll	Insight Nonsense
Fairy hot	Nightmare	Tiny Wrestler
Canadian Violinist	Dam Hideous	Day Hawk
John Doe	Awesome chocolate	Hangman
Crazy	Butterfly Kisses	Dolly Dolphin
Rainbow Blooms	Head Of The Middle	haltyoudoglovers
Lily	Red Queen	Curly Girly Bee
DaSnipeKid	OverKill	Fresh Foam
Painter Delight	DosentAnyoneCare	Foolish Admin
StoryOfMe	Lil Okie	Tellmeyouaremine
Blue Bus	Entertain-me	Dr. Cocktail
MadeInCharms	Gone by by	lefthandright
Sugarypinaplecake	neverforgetyourdreamss	julialaurene
Peppermint Kisses	Shrink Sand	SugerSprinkledWalrus
Magenta	Death	Songbird Garden
Sniper	Lego Lunch	Angel Munchkin
DivinityV2	printer	MisterModerator
Prometheus	Fish	Amours Hideous
Internet Monster	Usoka	Tubing Slamming
Paging Crying	NutsBrain	Jelly
FairLoose	Sallow	Oblivion
Peking Slamming	Old Regret	DroolingOnU
Chillipeppersalt	Last Smile Lost	Muffins n cupcakes
Slamming War	Sidewalk Enforcer	Doll
brilliant brun3tt3	Chillipepper salt	Honey Hug
ChowderBowl	Queen Honey Blossom	Cinnamon Bun
Teamleaderisme	Princess_land	Gold Grace
MissingSmile	I World	Love Graphic
Creamy Crevice	evil weevil	Friends Family Beer
Facer Racer	Eversincenever	Laser Painter
Native Nana	Demon Dreams	Cutlet
g00d vib3zzz	lolly	Gold Tube
Swerve	Youme Beer	X App
sparkles	Naught Chicks	Smart Swag
Love Pink	Hay day pay day	Beautiful doll
Thebestwoman	Richness Ride	Doodles
Crazy One	Hunky-Panky	Shiny Seashells
Gorgeous Hideous	NotMeThenWho	Snuggle Kitty
Doll Ex	Infinite	Orange Splash
Kunning-king	Lollipop Princess	Cute Eyes
Bob	Facebook Fart	Mobile Money
Disco Psycho	Gamer Simmer	Elegant Point
JeanClaudeVanDarnItAll	Anime Wanted	Thelollipopprincess
AngelHoneyBeer	Mr. Peppermint	Incident Incomer
Teen Hug	fire3232	Cull Harm
Peppermint	Rose lady	Cozy button
Troll	Passenger Plan	Still Dancer
Candycane Missy	Schmoople	Tune Major
Golden Panther	Sugarplum Chum	Punch Industry
Brutal	Racer Party	Face Cheer
Scott Evil	Hyper	Jungle Jones
Pie sweetness	Reality Bites	Roadblock
dark night bright days	D History	SeaBoundRhino
Sizzling Teapot	Dragon Arrest	broswen
Nearly Effective	KyoDemer	Beloved
s a v anna h	Baddest Buddy	Bliss
Tricky Mind	Peppermint Candy	LokiDarkfire
Butterscotch	CANTfindKEYBOARD	ChoclateOxygen
Passion Fruit	zada2011	Tiny Heart
Charming Angel	Tacklebox	Sweet Kristy
ANONYMOUS	Meaghan	deano
Chest Cheer	Bristle Marble	Bee – Sting
White Sand	neonmalu	Lovely Lights
CryingRock	Vegetarian Alien Brain	Soaked Lemon
SuperMagnificentExtreme	fairy	Miss T
Honey bean Angel	Left Ground	Sorriest ripping
Crazy Leader	Random Burglar	Glitter
Giant Paranoid	Cyborg	Honey Angelhearts
Dr. Angel	High Beam	Scarface
WhenSeptemberEnds	Sky Bully	if only weknew
Bubbles	Mix Snotty	Sarasota Kiss
Trustnoone	Hippy Sunshine	Bodhi
Sweet Blue	Heisme	snowflake
Demon	Neurotic	Max
Clumsy	Neo	Angel Wonderland
Croon Creamy	Ms. JB	TheChillPixel
Honey bear Doll	Successful Loser	Inpainsincethen
HeyYouNotYouYou	WarlockOPain	RootinTootinPutin
Cute sugar	Twitch	Cool pineapple
Idiot Fantasy	estrellaceleste	Best Peace
Sorry Cheer	Fruity Touch	Pager Plug
Tropical Storm	OutOfThisWorld	Maple Leaf
urbanLegend	Hulu Girl	Piping Crying
Crazy Focus	Charismatic – doll	Ninja
estupidaysensualnutella	Anonymous-Friend	RedKingdom
hipsterizeddolls	Afro-head	Legislation Kara
Hideous Nearly	Both Sides Coin	Midnight Rambler
Gail102	Nice Mouth	Tender Cross
Pretty Pumpkin	Twinkle Night	Compact Racer
Flyer David	vittyalex	Bubblegum
SheWalksInMoonlight	Oh Prediction	Pure Creamy
Lil Thug	Brownie	Cutesie Pie
Incident Serene	Kitty	Chunky Monkey
OnceUponADime	Roasted Frog	Seven Shots
Three better than 2	Unnecessary	Overtaking Dupe
Short Circuit	Jade Bad	PoPkiss
BloomingFlowers	Princess Punch	CreativeComma
Confirmed Science	Raging Again	sparrowsandcrosses
Bear In The Big Blue House	Natural Mess	Adman Woman
Out Of This World	MyownCrushMe	Awesome lavender
Girl with the3 br0ken smile	Smilee Doll	Nuts Brain
Moon Gun	Blonde Bond	Cool Whip
Triple Sense	Serious Classification	Say cute
It Wasn't Me	Angel twins	Smilee Love
tulipsunflowers	Grace Shower	Capri Crown
pooldude	TheAverageForumUser	Mars Blue
Leftfoot	Zod	Blacksmith Knife
Panda Protector	Afro head	Lofty Farm
Cookie Bear	Mylifeisabeautifuldisaster	Smile Everywhere
Cutesy	Squiggly Munchkin	Peanut Looks
Instant Hero	Rigger Scoter	FreedomCostsTax
Cheerier	Born Hyper	Shy Doll
Mutt	Mindset Player	Deadline Dork
Awesome American	home sweet 08	CoreOfLore
Sweet sparrow	In pain since then	kw 3 lest Brat
Problem Repeater	Angel Honey Beer	Glowing
Carmelpoptart	Zesty Dragon	Insta Genius
OpelSpeedster	Godfather	Smile Somewhat
Trumphant Loser	JesusoChristo	Synchrophi
Dam Sorry	Dilema Doll	Cupcake Hugs
Cross Thread	Massive Vision	Cool strawberry
Makesmewonderwhy	MelonSmasher	Rabbit Jump
Serus Haralain	Say Love	Say Something
Erak606	SometimesOkie	Watercolorist Hurter
Ricky run	Bold Touch	No Limits
qwert	Pink Garden	Moon Up
RandomIdoit	Rare Raw	Bean Basket
Love Creamy	Merrick Takaoka	Infamous Freak
OmnipotentBeing	e4envy	Sa v anna h
Asparagus Plan	Electric Player	Atlantic good looks
Cutie Bun	Bachelor Teacher	Esquire
endlesslyyy forrever	zak bishop	Dead Informed
Elegant pin up	Dear angel	lorindavi
Rooster	Super Magnificent Extreme	Jig summer
BrainCordConnection	Ghost	GamingChanging
Starry Angel	Ever since never	Summer Award
Cherub	grox19	Fun Gap
First Flow	Butterflyonrose	OrdinaryGentelman
Concerns Line	TheSuburbanErrorist	Cruiser
Glamorous angel	Pandora Plug	Night Show
Life Racer	left hand right	UnfinishedSentenc
Creamy Credo	Angel Cherub	Geekish-God
Ice Geek	Aggressively Cool	Tell me baby one more time
Awesome-Me	Affordable Love	Nomnomguy
Mayahem	Robin Retire	White Vegas
Pearce Pure	Grapy Soapy	California Lionfish
Genius General	Heavenly	LastSmileLost
Iamthefuturequeen	GodsOwnGirl	TwinkleTwinkle
Hotcakes	Special Son	Mr Extinct
Internet Princess	toni rapp	Honey Goldfish
Angelberry	Kozmo	In Two Pieces
SpeedyAstro	Dog Bone	CastBound
IntradouchingMyshelf	Sensor Glass	Flame
second kisses	Swag Headlines	Brain Dead
Binder Sorry	RedOcean	Yourealion
PastHaunts	Mind Freezer	Women Spin
Swing Shine	Red Dairy	Coffee Rule
Lady Benz	Honey Butterfly	kartier klass
Moon Down	Irritating Love	Pink Page
princess	Dream girl	Tarry Damn
Tech Bro	Technophyle	sparkly
Married Man	Honey Stars Sunshine	BlahBlahBlackSheep
Ridge Runner	FriendsFamilyBeer	Snowier
Wild Born	Diva hot	Skull Crusher
Magic Peach	Fantastic Fool	Kunning king
Cheered No	CrunchyCrunch	Hideki Riyuga
Rare Rips	never forget your dreams	Cute Ownership
FirstNLastLove	Black Square	Neophyte Believer
Mr. America	Hazzle-Dazzle	2Star Princess
Twister	last1youlove	Creamy Crux
Techdolpihn	Teen punch	Silvermoon
Cool dora	CurlyGirlyBee	Glory Pure
the con she called love	Cool Beans	Maid Cheer
Lil Puppy Dog	Cute Scientist	diamondhand146
Opera Of Dreams	copilot	Lodi Creamy
Guillotine	Love Speeder	Tiny Force
goodatthis123	ImaCompleteCyclePath	Great
Work of holly	Mr. Lucky	Mom Crying
Cutie Pie Shop	cra zy vib es	Live Chic
Hi Buggy	Mississippi Tribe	Soft Mambo
Peace Hug	Crack Gun	sweetie
Warrior In Pain	Babykins	AngelOfMemories
Hello Goodbye	Butterscotch Seven	Baby Slamming
Daily Punch	Missing Smile	Squatch
Angel Doll	Bull Frog	Dove girl
Twin butterfly	mylifeline21	Threebetterthan2
Silly Ninja	Pure Vegan	Honey Blossom Dimples
Dark	marett	Winning Mob
Luis	Soweto	Fresh Face
Pretty Law	Teen Graph	Strides Drink
Tigger Fresh	Jelly Cuddles	FoxHound42
Cuteness	Enigma	Rocking Profile
David	livinglouder29	Goddess
Rumor Ring	RoastedFrog	SecondsOfkisses
DefaultAsAwesome	Destination Blood	Buckshot
Viral Witch	Firestix	Flying Mouse
Princess Taste	Naughty Slay	Forget Followers
Last Min stand on the Earth	Wrong Advisor	Couch King
ForBlueS	Snows noose	Story Of Me
Honey Maker	Delicately-delicious	CandyRaid
Beauty-Fool	El Pollo Loco	alwayssbeyou
runfromp	Natural nock	Ever Next
PrincessKingdom	Shy Snicker	Far Racer
bittersweetthoughtsofinsanity	glimmer	Dimples
Marshmallow Honey	Maryjane	Dolly Dangerous
Ex Promoter	Beloved – Angle	Barber Cut
Bundle of Love	Iloveyouyesterday	Gorgeous sweetie
Solid Crying	Super Nigga	ValkonX11
John Carsweel	Just As Planned	infinity skylines
Dave Days	NONAME	Honey cake Blossom
pinkv0dka	neveroldenough	Couldnt Find Good Name
Angel Memories	Teen Touch	Jaycee
Roxrite	GreenCore	Dracula Nurse
Damnation Kiss	unic0rns taking0ver	Kral III
Honeybear	PlantedBrain	Mistake Manager
Enchanted	Cheesy Nible	Dazzles
Post Ghost	Improved Guy	Monkey
RtYyU36	Killer	taken by Wine
sprinkles	Undiscovered Yet	Zombie Edge
Sandstorm	Flower Fine	Tonight Gamer
Lasmo	Zenith Lead	capncrunchcx
Unforgettable Gal	Miss Cake	BothSidesCoin
Missie Lucky	Arrow	Sugary pie
Spiral Drop	Scribbly Lightning	mywholeotherworld
Teen Smile	Fairy Fresh	Polar Mode
Nice Breeze	Judy Holly	Tina Fey
Inspiration	Certain	Exotica
Genius-generous	Angry Eagle	Moon killer
Hideousness Life	homesweet08	bearhugs
pretty	Jolly	Snow Angel
NoisYBoY	BlackmanAndRobbin	OneTonSoup
Legal Heart breaker	Grip York	Snowy Secret
Foxy role	Sweet Quail	Starhawke Mystery
BaddestBuddy	SmothersTheWorld	Awesome Dreamer
Little Cobra	Tom	Pegasus
Mindless Bobcat	Eye Roller	Scrapper
Lollipop Honey Bear	Honey bear Pearls	Seeker
UndiscoveredYet	escap3 with me	Princess Kristy
Naught Trends	Smoking_Krills	Dam Boot
Precise	Angel Girl	Frozen Gas
Social Creamy	Lil Cutie	Swag Grant
Noisy Noise	MicrowavedGerbil	Sugary cake
Happiness	Winning Looser	Heres20BucksKillMe
You Just Might	Blooming Flowers	Sortie Sorry
Macho Moron	Crying Doting	Big Thumb
Love Hearts	Dark Horse	YellowMenace
Hellboy	Bee	Stale Milk
geez	WishIhadYou	Workofholly
Honey pie Girl	Analyst	NoDadNotTonight
Minor Leak	Beauty Babe	Blossom
K Clever	WhistleThuslyTWEET	AlQaholic
urban Legend	Zero Exogamy	Romeo
Angel Honeybear	Usernamenotfound	pink
Mad Boxer	Romeos – cousin	Beauty Tech
Rainblow Bubbles	Painter Mysterious	Single Tomorrow
Hitch Hiker	Smiley Doll	Broomspun
Haggy Pie	Red Cream	Dixie
Scratching Facts	Twinkie Star	Cupid
niightdreamer	In Between Heaven	Born-confused
Fairy Princess Kristy	raremixedchick	i Like Me
Naughty Tiger	Creamily	5th angel
Little Trout	Shocking Cart	Muffins
Veal Deal	Greek Goat	Dazzled Sweetie
Lime Green Soda	Apple Honeypie	Fixin
TestNamePleaseIgnore	Sugar Hugs	Psycho Thinker
XmysteriousX	Chekhov Fun	Teen Rose
Sorry Sorcery	Bite Glory	cejj99
Screwtape	scyp10	peap0ds
White Pasta	Lad of Look	PrincessLand
Luvitus	Naughty Matrix	Casiie s
Future Coach	Elated Wanted	Metalhead
Red Tower	Captain	Snack Lips
Draconus	Elegant Jump	MadameHoussain
Rochambo	Not Me Then Who	LordOfMud
kw3lestBrat	The Dude	Secret Fruity
Shades Soapy	Space Walker	CyberKing
Broken Smile	Jellybeans	Melody